|--------|
|...|..-.|
|..-|.@..|
|........|
|--------|
